1111111111111111111111111111111111
1E0000000000000C00001C000000000001
1110010100100000101001000000010101
1110010010111011111001000000010101
1P0000000C01C0000000000000000101C1
1111111111111111111111111111111111