1111111111111111
100000000C0000P1
1000111000000001
1E00111C00000001
1111111111111111
