11111111
100000P1
1C000001
10000001
11111111