1111111111111111
10000A000C0000P1
1000111000000001
1E00111000000001
1111111111111111
