1111111111111
10A000C0000P1
1000000000001
1E00000000001
1111111111111
