11111111
1E0C10P1
00000001
10000001
11110111