11111111
10000001
1C000001
10000001
11111111