111111111111111
100000000000001
10000P000000001
100C00000C00001
1000000E0000001
111111111111111