1000001
1100001
1011111
1111111