111111111111
10000P1000E1
1CC000100001
111111111111