11111111
1E0C10P1
10000001
10000001
11111111