111111111111111
1C0000000000001
10000P111000001
100C01100C00001
1000010E0000001
111111111111111