111111111111111111111111111111111
100000000C0000P1111000000000001C1
100011100000000000000010000000101
1E00111C0000000100100010000011101
11111111111111111111C111110000001
111111111111111111111111111111111
