11111111
100000P1
10000001
10000E01
11111111