11111111
10000001
1C000001
10000E01
11111111