11111111
1E0C10P1
1000001
10000001
111111111