11111111
100P0001
1C000P01
10E00001
11111111