11111111
100000P1
1C0E0001
1000E001
11111111